!!!!!!!!!!!!!!!!!!!!!!!!!!!!!!!!!!!!!!!!!!!!!!!!
!               =     !!!!          !!!!    K  !
!!!!!!!   &                                    !
!    P       !!!!!!!!!!       @   !!!!!        !
!!!!!!!!           !!!!!!!!!!!                 !
!        @                                     !
!!!!!!!!!!!!!!!!!!!!    !!!!!!!!!!!!!!!!!!!!!!!!
!                              &               !
!     !!!!!!!       !!!!!!!!!!!!!!!!!!!        !
!      &                    @                  !
!  !!!!!!!!!!!!!!!!   !!!!!!!!!!!!!!           !
! &                                            !
!!!!!!!!!!!!!!!!!!!!!!!!!#!!!!!!!!!!!!!!!!!!!!!!