!!!!!!!!!!!!!!!!!!!!!!!!!!!!!!!!!!!!!!!!!!!!!!!!
!               =     !!!!                     !
!!!!!!!   &                                    !
!    P       !!!!!!!!!!           !!!!!        !
!!!!!!!!           !!!!!!!!!!!                 !
!                                              !
!!!!!!!!!!!!!!!!!!!!    !!!!!!!!!!!!!!!        !
!                              &               !
!     !!!!!!!       !!!!!!!!!!!!!!!!!!!        !
!      &                                       !
!  !!!!!!!!!!!!!!!!   !!!!!!!!!!!!!!           !
! &                                            !
!       !!!!!!!!!!!!!!!!!!!!!!!!!!!!!!!!!!!!!!!!
!                                              !
!      !!!!!!!               !!!!!!!!!!!   K   !
!        P                   &                 !
!!!!!!!!!!!!!!!                                !
!                                              !
!            !!!!!!       &          !!!!!!!!!!!
!!!!!!!!           !!!!!!!!!!!                 !
!                                              !
!       !!!!!!!!!!!          !!!!!!!!!!!!      !
!          &       !!!!!           @           !
!!!!!!!!!!!!!!                      #          !
! P                !!!!!!!!!!!!!        !!!!!!!!
!                        &                     !
!!!!!!!!!!!!!!!!!!!!!!!!!!!!!!!!!!!!!!!!!!!!!!!!