!!!!!!!!!!!!!!!!!!!!!!!!!!!!!!!!!!!!!!!!!!!!!!!!
!  =                  !!!!                     !
!!!!!!!   &                                    !
!    P       !!!!!!!!!!       @   !!!!!        !
!!!!!!!!           !!!!!!!!!!!                 !
!        @                                     !
!!!!!!!!!!!!!!!!!!!!    !!!!!!!!!!!!!!!        !
!                              &               !
!     !!!!!!!       !!!!!!!!!!!!!!!!!!!        !
!      &                    @                  !
!  !!!!!!!!!!!!!!!!   !!!!!!!!!!!!!!           !
! &                                            !
!       !!!!!!!!!!!!!!!!!!!!!!!!!!!!!!!!!!!!!!!!
!                    @                         !
!      !!!!!!!               !!!!!!!!!!!   K   !
!        P                   &                 !
!!!!!!!!!!!!!!!                @               !
!                                              !
!            !!!!!!       &          !!!!!!!!!!!
!!!!!!!!           !!!!!!!!!!!                 !
!                                              !
!       !!!!!!!!!!!     &    !!!!!!!!!!!!      !
!          &       !!!!!           @           !
!!!!!!!!!!!!!!                      #          !
! P                !!!!!!!!!!!!!        !!!!!!!!
!                        &                     !
!!!!!!!!!!!!!!!!!!!!!!!!!!!!!!!!!!!!!!!!!!!!!!!!